SOXXOOOXOOOOOOXOOXXOOOOXXOXXOOXXOOOXXOOOOOXOOXXXOXOXOXXXXXXOOOOOOOOXOXXOOOXXOXXXOOOXOOXOOOOXOOXXOXOX
OXOXOOOXXOOXOXOOXXOXOOOXOXXXXOOXXXOOXXOOOXOOOOOOXXOXOOOOXOOOOOOXXOOOOOOOOOXXOOOXOOXXOXXOOOXXOXOOXXOX
OOOXOXOOXXXOXXOXOOXOXXOOOXOOXOXXOXOOOOXOOOOOOOXXXOOOOOOXOOOXOOOOXOXOOOXOOXXOOOOOXXXOOOOOOXOOXXXOOOXX
OXOXXXXOXXOOXOXXOXOOXXOXXXOOOXXOXOXXOOXOOOOOOXOOOXXOXOOOOXXXOOOXOOOXOOOOOOOXOXOOXOOOXOOXOOOOOXXOXOOO
OOXOXOOXOOOXOOOOXOOXXXOOXXOOOXXXOOOOOOOOXXXXOXOOXOOXOOOOXXOXOOOOOOOOOXOOXOOOOXXXXXOXXOOXOOOOOOOOOOOX
OXXXOOXOOOOOXOOOXXOOOOOXOXOOOXXXOOOXOXOOOOOOXOOXOOOOOOOOXOOOXXXXOXOXXOOOOXXOXXXOOXXOOOOXXOXOOXOXOXXO
OXXOXOOOOOXXOOXOXXXOOOOXOOOOOOXXOXXXOXOOOOOOOOXOOOXOXXXOOXXXXXXOOXXXXXOOOOXOOXXOOOOOOOXOXOOOOOOOOXXO
OXOOOXXXXOOOOOOXOXOOOOXOXXXOXOXOOOOOXOOOOOXOOXXXXXOXOXOXOOOOXXOOXXOXOOXOXXOXXOXXXXOXOOXOOOOOOXOXXOOO
OOXXOOXXOOOXOXOXOOOXOOXOXOOXOXOOOOOXOOOOOOOXXXXXOXOOOXOOOOOXOOXOOOOXOOXXOXOOXOOOOXOOOOXOOOOXOXXOOXOO
OOXOXXOXOOOOXXOXXOOXOOXXXXOOXOXOXOOOOOOOOOXOXOOOOOOXOXOXOXOOOOXOXOOXXXXOXXOOOOOXXXXXXXOXXOOOOOXXOXXO
XOXOXOOOOOOXXOOXOOOXXXXXXOOOXOXOOOXOOOXXOXXXXXOXXOXOXXOXOXXOXXXXOXOOOXXXOOOXOOXOXXOXXXXOXXOOXXXXOOXO
OOOOOOXOOXXOOXOOOXXOXXOOOOXOXXOOOOXOOOOXXXOOOOXOOXOOOOOXOOOOOOOXOXOOOXXOXOOOXXOOOXOOOOXOOXOOXOOXOOOO
XOOOOOOOXOOOOOOOOOOXOOOOOOOXOXXOXOOOXOOOXXOOXOOOOXOXXOOOOOOOOXXXOXOXXOXOOXOOXOOXOOOXOOOOXOOXOOXXXOXO
XOOOOXOOOXOXXOXOXXOOOXOOOOOXXOOOOXOOOOOXOOOXXOXOXOOOXXOOXOXXOXOXOXOXOOXOOXXXOOOXOOOOOOXXXXXOOXOXOXOO
XOXOOXOXOOXOXOOOXXOOOXXOXOOXXXOOOOXOOOXOXXXOXOXOOOOOOOOOOOOOOXXOXOOOOXOXXOOOXOOOXOOOXOXXOXOOXXOXXOOO
OOOXOOOOXXOOOXOXXOOXXOOOOXXXXOOOOOOOOOOOOOXOOXOXXOOOOXXXXXOOXXXOOXOOOXXOOOOOOOXOOOOOOOOOOXXOOOOXXOXX
OOOXXXOXOOOXOXXOOOOOOOXXOOXOXOOOOOXOXOXOOOXOXXOXOXXXOXOOXXXOOXXOXOOOXOXXOXXXOOXOXOXXXXOOXOOXOOOOOOOX
OOXXXXXOXOXOXXOXOOOOOXOOOOOOOXOOOOOXOXXXOXXXXOXXOOXOXOXXOOXXOOXOXOOXOXOOOXOOOOOXOOOOXXOOOXXXOOOXOOXO
OOOOXOOOXOOOXXXOXOOXOXOOOXOOOOXXXOXXOOOOOOOOOOXOOOOXXXOOOXOOOOXOOXXXOOXOOOOXXXOOXXXOOOOXOOOOXXXOOXOO
OOOOOXOOOOOOXOOOOOOOXXOXXXOOXOOXOXXXXXXOXXOOXOOXXOOOOOXOXOOOOOOOXOXXOXOOOOXXOOXOOXXOOOXOXOXXOOOOOOOO
OOOXXOOOOXXOOXXOXOOOXOXXXXOOOOXOXXOXOXXOXXXOXOOOXXXOXXOXOOOXOOXOOOXXXXXXOXXOXXOXOOOOOXXXOXOOXXOOXOXO
OXOXXXXXXOXXOOOXOOXOOXOXOXOOOXOOXXOXXXOOOOXXXXXOXOOOOOOXOXOXXOOOOOXOOOOOOOOOXXXXXXOOOOOOXOXXOXXXXXXX
XXXOOXOXOXXOXOXXXOXOOOOXXOXOXOOOOOXOOOOXXOXXXOOXXOOXXOOOOOXXXXOXOOOOXOXOOXOOOXOOOXXOOXOXXOOXOOXOXXOO
OXOOOXOXOOXOOOOXOXXOOOOXOXOXOOOOOXOOXOOOOOOOOXXOXOOOOXXXXOXXXXXOOOXOOOXOXXOXOXOOXOXXOOOOXXOOXOOOOXOX
XXXOOOOOOOOXXOXXOXOOXOOOXOXOOXOOOOOOOOXOOXOXOXOOXXOXXOXOOXOXOOOXXOOOXOXXXXXXOOOOXOOOOOOOXOXOXOOOOOXO
OOXOOXXOOOOOOOXOXOOOOOXXOOXXXXOOOXXXXXOXXOXOXXXXXOOOXOXOOXXXOOOXXOXXOXOXOXXXOOXXOXOXOXOOOXOOXOOXOOXO
OOXXXOOOXXOOXOOOOXOXOOXOXOXXOOXOOOOOOOXOXXOOXOOXXOXXXOOXOOOXOOOOOXXOXXOXXOXOXXXOXOOXOOOOOXOXOXXOXXXX
OXXXOOXOOXXXXOOXOOOOOXOXXOOOOOOOXXOOOOOOOXXOOOOXXOOXXXOOOOOOXXOXOXXXXXXXXXXOOXXOOOOOXXOXOOXOOOXOOXXO
OOXXOXOXXXXOOXXOOOOXOOOXOOXOOOOOOOXOOOXOXOXXOOOOOOOOXOOOOOOXOOXOXOOOOOOXXOXOOOOOXOOXOXXOOOOOXXOXXOXX
XOOOOOOOOXOXOOXXOXOXXOOXOXOXXOOXOOOXOOXOOOXOOOXOXOOXOXOXXOXOOXXOOOOXXOOOOOXOOOXOOOOOXOXOOXXXOOXXOXXX
XOOOXXXXOOOXXOOOOOOOXXOOOXXXOXOOOXOOXOXXXOOXOXXXOOOOOOOXOOOOOOOOOXOXOXOOOOOXXXXOXXOXXXOXXXXXOXXXXXOO
OOXOXXXOOOXXOXOOXOOXXXXOOXXXXOXXXOXXXOOXXOOOOXOOOOOOOOXXOXXXOXOXOXXXXOOOOXXXOXOOXOOOOOXOXOXOOOXOXXXO
OOOOXOOOOOXOXXOXOXOOOXOXXOOXXXXOXXOOXOOXOOXOOOOOOOXXOXXOXXOOOOXXOOXXOOXXOOOXOXXXXXXXXOXXXOOOOOXOOXOX
OOOXOXOOOOOOOOXOOOOOXXXOOXXOOOOOXXOOXXOXXXXXXOOXOXXOOOOOOXXOOOXXOXOOOOOXOOOOOOOXXOXXXOXOXXOXOXXXXXOX
XXXOOXXOXOOOOOXOOOOOOOOOOOOOOXOOXXXXOXOXOOXXOXOOOXOXXOOXOOOOOOXXXOXXOXXOOOOXOOXOOOOXOOXOOXOOOOOXOOXO
XXXOOOXOOOXXXXXOXOXXOOOOOXXXXOOOXOOOOOXOOOOXOOOXOOOOOOXXOXXOOXOXXXOOOOXOOOOOXXOOOOXXXOOOOXOXXOXXXOXO
OOOXOXXXOXOOOOOOOXXOOXXOOOXOXOOOXOOXOXOOXXOXXXOOOXOOXOOOOOXOXXOOOOXOOOOOOOXOOXXOXXXOOOOOOXOOOOXXXXOX
OOXXOOXOOXXOOOOOXXOOXOXXXOOOXXXXXXOXOOXXXOOOOXXXOXOXOOOXOXXOXOOOXXXXOXOXXOOOOOXOOOXOXOOOXOOOOXOOXOOO
XOOXXOXXXXXXOXXOOOXXOOXOOXXXOOOXOOOOOXOOOXOOOOXOOXXXXOXOOOXXXXOXOOXXXOOXOOXOOXOXOOOXOXXOXXOOOXOOXXOO
XOOOXOOOXOOOXOXOOOXOOOXXOXOXOOXOXOXXOOOXXXXXOOOOOXXOXXOOOOXXXOXOOXXOOXOXOXOOOOOXOOOOOXOXXOOXXOOOXOOX
XOXOOOOOOXXOOXOOOOXXOXOXOXOXXOOOXOXOOXXOXOXXOOXXOOOOXXOOOXOXOOOXXXOOOOXOXOOXOXOXOOXOOXOOXXXOXOOOOXOX
XOXXXOXOXXXXXOXXOOXXOOOOOOOXXXXOOXOXOXOXOOOOXOXOOOXXOOOOOOXOXXOOXXOOOXOOOXOOXOOOOOOOXXOXOXOXOOOOXOOO
OXOOOOOOXXXOOOOOOXOXXOXOOOOOOOXOXOXOXXOOOXXXOOOOOXXXOXOOOXOXXOXXOOXOXOOXXOOXOXOOOOOOXOOOOOOXOOOOOOXX
OOOXOXXXOXOOXXOXXOOXXOXOOXOOXOXOOOXXOOOXOOXOOOOOOOOXOXXXOOOXXXOOOOXOOOOOXOXXOOOXOXOOXXOXOXXOOXOOOXOX
OOOOOXXXXOOXXOOOXXOOOOXOXXOOOOOXOXOOOXXXOOXOXOXOOXXOXOOOOOXXXOOOXXOXOOXXXOOOOOOOXXOOOXXOOOXXXOOXXOOX
XOOOOXOOXOXXXOXXOOXXXOXOOOXXXXOOXOXXOXOXOOOXXXXOOOOOOXOOOXXXXXXOOOOOOOOOXOOOOOXOOOOOOXOOOOOOXOXXXOOO
XOXOOXXXOXXOOXOOOOXOOXOOXXOOOXXOXOOXOOOXOOXOXOOOXOOOOOOOOXOOOOXXXXOXOOXOOXOXXOOOOOOXOOOXXOXOOOOXOOXX
OOXOOOXOXOOXOXOOXXOOOXOOXOXXOOOOXXOXOOOOXXXOXXXOOOOXOOOOOOOXOOOOOOXXXOXOOXXOXOXOOXOOXXOXOXXXXOOOXOOX
XOOOXXXOOXXXXOOOOOOOXOOXOXXXXOOOOOOOOOOOOXOOOXXOOXOXXOXXOOOXXXOOOOXXOXOOXOOXXOXXXXOOOXXOOOOXXOOOXOOX
XOXOOXOOOXXOOXOOOXXXOOXXXOOOOOOXXXXXOXXOXOOOXXOOOOOXOOXXOXXOOOOXXXOOXOOXOOXXXOOXXOOOOOOOOOOOOOXOOXOX
OXOXXXOXOXXOXXXOOOOOOOOXXXOXOXXXXOXXOOOOXXXXOOOOXXXOOOOXOOXXOOOXXXOOOXXXXOOXOOOXOOOXOXXXXOOXOOOOXXXX
OOOXXXOOOXOOXOOXOOXOOOOOOXXXOOXXXXOOOOXOOXOOXOXXXOOOOOOXOOXOOOXOXXOOXOOOXOXOXOOXXXXXOXOOOOXOOXXOXOOO
OXOXXOOXXOOOXXOXXOOOOXOOOOOOXXXXOOXOOOXOOXXOOXOXOOOXXOXXXXOOOOOOOOXXOOOOOOXXXXOOOXXOOOOOOXOXOOOXXXXX
XOOOOXOOOOXXOOOXXOXOOXOOOOOXXOOOXOOXOOOOXOXOOXOOOOXOXOOOXOXXXOXOOXXOXOXXOXOXOOOXXXXOOXOOXOXXOOOOXXOO
XOOXXOOOOXXOOOOOOXXOXXXOOXOOOOOOOOXOOOOOXXOXOOXXOOXXOOOOOOOXXOXXXOOXOOXOOOOXOXXXOOOOOOOOXXOOXOOOOOOX
OXXXOOXXXOXXOOXOOOOOOOOXOXOXXXOXOXXOXOOXOXOOXOXOXOOXXXXXXXOOXXXOOOOOOOOXOXXOOOXOXOOXOXXXOOXXOOXXXXOX
XXXOXOXXXOOOOXOXOOXOOOOOXXXXOXOOXXOOOOXOXXXOXOXOXXOXXXXOXXOOXXXXOOOOOOXOOXXOOOOXOOOOOXOOOXOOXXOXOXOO
XOXOOOOOXOOOOXOOXOOOXOXXOOOOOOXOOXOXOOOOOOOXXOOOXXOXOXXOOOOOXOOXOOOOXOOOOOOOXOXOOOOXXOOOXOOOXOOXXOOO
OXOOXOXOOXXOOXXOXXXOOXOOXOOOXXOOXOOOXOXOOXXOXOXXOOOXOOXOOOOOOXOXOOXXXOOXOXOXXOOXOOXOXOXOXXOOOOOOOOXO
OXOXXOXXXOOXOXOOXOOOXOOOOOOXOXOXOOOXOOXOOXXOOOOXOXOOOXXOXXXXXOOOXXOXOOXXOXOXOXXXXOOOOOXXXXOOOXOOOOXO
XOOOXXXOOOXXOXXOXOOOOOOOOOOOOOOOXOXXOOOOOOXOXOOXOOOOOOOOXXXOOOOOXXXXXXOXXXXXXXOOOXOOXOOOOOXOOOXXOXXO
OOXOXXOOXOOOOXOXOOOOXOOOOOOOOXXOXOXOXXOXXOXOXOXXXXXOOXOXOOOXOXXXOOXXOXXOXOOXXOOOOOXOOXOXOXOOXOOOOXXX
XXXOOOOXOOOOXOXXOXXOOXXOOOOOXOXXXXXOXXOXXOOXXXXOXXOOOOOOOXXOXXXOXOXOXOOOOXXOOOOOXOXOOOOOOOOOOXOXOOXO
OOOOOXXXOOOOOOXOOOOXOOXOOXOXOXXXOOXOXOXOOXXOOOOOXXXXOOXOXXOXXOOXXOXXXOOXXXOOOOOXXXOOOXOOOXOOXOXOOOOX
OOXOOXOXXOOOOOXXXOXXOOXXOOOXXOXXXXOXXXOOXXXXXXXOOXOXXXXOOOXOOOXOOOOXOOOOOOOOXXOOXOOXXXOOXXOXXOXOXOOO
OXXXXOOOOOXOXOOOXXXOOOOOXOOOOOOOOOOXOXOOOXXOOXXOOOOXOXOXXOXXXOXOXOXOOOOOXOOOXOXXOOXOXXOXXOOXXOXOXOOO
XOOOOXXXXOOOXXOXOXOOXOOXOOOXOXOOOXOXOXXOXOOOOOOXXOXXXOOXXOXXOOOXXOOXXOXXOOOOXXXOOXXOXXOXOOOXXOOXOOXO
XOXOOOXOXOOXOOOXOXXOXOXXOXXXXXOOOXOOXOOOXXXXOOOOOXOOOOOOOXOOXXOOXOXXOXXOXOOXXXXOOOXOXOXXOOXOXXXXOOOO
OXOOXXOOOXXOOOXOOOOXXXOOXXOOOOOOXOOXXXOOXXOXOOXXXOXXOOXXOOOOOOXXOOXOOXOOOOOXOOXOOOOXXOOOOXOOOOXOXXOX
OXOXXOXOOXOOXXOXXXXXOOXXOOOOOXOXXOXOOXOXOOOOXOXXOOOOXOOOXXOXOXOOXOOOXXOOXOOXOOXOOOXOOOXOXXOOOOXXOOOO
OOXOXOOXOOOOXXXXXXOXXXXOOOXOOXOOOOOXOXOXXXOOOXOXXXXXOOOOOXXXXXOOXOOOXXOOOOOXXOXXXOXOXXOOXXOOXXOXOXXX
OOXXOXOOOXOOOOXXXOOOOXOXOXOOOOXOOOOOOXOOOOOOOOOXXOOOOXOXXXOOOOOOXOXOOOOXOOXXXOOOXXOXOOXXXOXOOOXOOXOO
OOXOOOOXXOXXXOXOOOOOOOOOXOOOOOOOXOOOOXXXOOXOOOOOOOXOOXXOXOXXXXOOXXOXXOOXOOOOOXXOXOOXXOXXOOOOOOOOXOXX
XXOXOOOOXOXOOOXOXOOOXOOXOOOOOXXOXOXOXOXXXXXOOOOXOXXOOXXOOOXOOOOXOOOOXXOOXXOOOOXOOXOOXOOOOOXOOOOXXOXX
XXXOOOXOOXXOXXXXXXOOXOXOOOOOOOOOOXOOXOXOOOXOOOXOOXOXXOXOOOXOOXOOOOXXOXXOOXXXOOOXOXOOXXOXXOOOOOOOOOOX
OXOXXXOOOOXOXOOOOOOOXOOOXOXXOOXXOXOOXXXOOOOXOOOOOXOOOXXOXXXOXXXOOXOOOOXXXOXXXOXOXXOXOOOOOOXXXOOOOOOO
OOXXXOXOXOOOXOXOXXXOOXOOXOXXOOOXOOOOXOXXOOOOXOXOOXXOOXOOOOOXOXOOXXOOOOOOOOXOXXOOOXOOXOOOOOOOOXOXOXOO
OXXOOOOOOXOOOOXXOXOOOXXOXOOOXXOXXOXOXOXOOOXXOOOOXOOOOXXOXOOOOXXOXXOOOOXOXXOOXOXXOOOOOXOOOOOOXXOOOOXX
XXXOOOOOOOXXXXOOOOXOOOOOXOOOXOXOOOXOOXXOOXOOOXXOOOOXXOOXXOXXOOXXXOOOXXXXXXXXOOXOXOXOXXXXOOOXOXXOXOXO
OOOOOXOXXOXOXOOXOOOXXXOXOOOXXOXXXXXXOOOXXXXXOOOXXOOXOOOOXOOOOOXXXXOXOOXXOOXXXXOXXOOXOOXOOOXXOXOOOOXX
XOOOOOOXOOXXOOOXOOXOXOOOOOXOXOXOXOOOOXXXXOOXOXOOOOOOXOOXXOOXOOXXXOOOXXXOOXXOOOXOXXXXOXXOOOXOXXOOOOXO
XOOOOOXXXOOOOXXXOOOOOXXOOXOOXOOXOOOXXOOOXOXOOOOOXOOOXXOOOXOXXOOOOXXOOOOXOOOOOOOXOOOOXXXXOOOXXOOOOOOO
OOXOXOOOOOXXOOXOOOXOXOXXXOOOOXXOOOOXOXOOXOOOOOXOOOOOOXOOOOXXOOOXOXXOXOXOOOXOXXOOOOXOOOOOXOOOOXOOOOXX
XOXOOOOOXOXOXOOXOOOXOOOXXOOOXOXOXOXXXOXOXOXOOXOOXOOOOOXOOXOXOOXOOOXOOOOXOOXOXXOOXXXOOXXXXOXXOXOXOOOX
XOXOOOOOOOXOOOOOOOXOOOXXOOOOOOOOOOOXXOOOOXOOXOXXXXOOOXOXOOOXXXOXOOXXOOOOXXOXOOXXXXOOXOOXOOOXOOOXXXOX
XXXOOOXOXXOXOOOXOXOOXXOXXOXOOOOXOOXXXOXOOXOOXXOXOXOXOOXOOXOOOOOOXOOXOXOOOXXOXOXOXXOXXOOOXXOOOXXXOOXO
OOXOOOOXOOOOXOOXOXXOXOOOOOOOOXXOOOXOOXOOXXXOXOOOXOXXOOOOOOOOXOXXOXXOXXOXOXOOOOXOXOXOOXXXXOOOOOOOOXXO
OXOXOXOXXOXOOXXOOOOXXOOOXOOOOXXOOXOOOXOOXOXOXXXOXXOXOOOXOOOXXOOOOOXXXXOXXOOXOOOXXXOOXOOOOOXXXXOOXXXO
XXXOOOXXXXOOOOOXXXOOOOOOXXOOXOXOOXOXXOOOOOOXXOXOOXXOXXOOXXOXOOOOXOOOOOOOXOXOOOOOXXXOXXXOOXOOOOOOXXXX
OOOOOOOOOOOOOXXOXXOOOXOOXXOXOOOOOXXOOOOXOOOXXOXOOXXXOXOXOXXXXXXOOXXOXOOOOXXXOOXXXOOXXOXXOOOXOXOXXXOX
OOOXOOXXXOOXXOXOOOXOXXOXOOXOOOOXOXOXXOOXOOOOOOXOOXOOOXXOOXXOOOOOOXXXXOOXOOXXXXOXXXOXXXOOOXOOXXOOXXXO
OXOOOOOXOOXOOOOOXOOOOXXOXOOOXXXOOOOOOOXOOXXOOOOOOXOXOOOOXOOOOOOOOOOXXOOOXOOOXXOOXXXXOOXOXXOOOOOOOOXX
XOXOXOXOOXOXOXOXOOOOOXOXOXOOXXOOOOOXXXXXOXOXOOOOOOOXOOOOOOOXXXOOXOXXOOXXOOXXOOOXXOXOXOOOOOOXOOOOOXOO
OOXXXOOXXOOXXOOOOXOOOOOOOOOOOXOOOOOOOXXOXOXXOOXOOXOXOXOOOXXOOXXXOXXXOXOOOOOOOOXOOXOOOOXOOXOOXOOOOOOO
XOOOOXOOOXOOOOOXOOOXXOOOOXOOXOXOOOXXOOOXOOOOXXOOXOOXXXXOXOOOOOOXOOOXXOOOOOXOOOOOOOOXXXOOOOOOXXXXOOXX
XOXOOOXOXXXOXXXXOXXOOXOOOOOOXOXXOXOXOOOXOOXXXXOOXXXOXOOXOOOXXOOXXXXXOOOXOOOXOXOXXOXOOOOXXXXOXXOXOXXX
OXXXOXOXOOXOXXOOOOOOXXOXOOOOOOOOXXXXOOOXOXOOXOOXXOOOOOXOXOOOOOOOXOXXXOXOOXOOOXXOXOXOXOXOOOOOOOOOOOOO
OOXOXOXXOXOOOOOOOOOOOXXOXXXOXOOXOOXOOOXXXOOOOOXOXXXXXOXOXOOXOOXXOOXOOOOOOXXOXOOXOOOXXOOXOOOOOOOOOOXO
OOOXOOOOOOXOOXXXXOOOOXXXXOXOOOOOXXXXOXOOXOOXOOXXOXOXXOOOOOXOXOXOOOXOXXOOXXOXOOOOOXXOXOOOXOOXXOOXOOXO
OOOXXOOOOOXOOOXOOOOXXOXOOOOOOXXXOXXOXOXOOOOOXXXOXOOXOXOOOXOOOXXOOXOOXOOXXXXOOOOOXXXXOOOXOXXXOOOOXXOE