SOOOOOXXXX
OXOOXOOOOO
OOXXOXOOOO
XXOOXXOOOO
OXOOXOOOOX
XXOOXXOOXO
OOOXXOOXXO
OXXOXXOOOO
XOXOOOOOXX
OXOXOXOOOE